rec_key,Geography_refkey,Datagroup,Datagroup_Order,Year,Large: 100+ Employees,Medium: 50-99 Employees,Small: 0-49 Employees,Total
1,pro9046,Retail Trade,8,2011,93,150,6503,6746
2,can,All Industries,1,2010,22250,29196,2311414,2362860
3,can,All Industries,1,2011,21527,28801,2354995,2405323
4,cnt1201,All Industries,1,2011,5,13,1313,1331
5,cnt1201,All Industries,1,2010,3,12,1357,1372
6,cnt1202,All Industries,1,2011,17,21,2028,2066
7,cnt1202,All Industries,1,2010,18,23,2031,2072
8,cnt1203,All Industries,1,2010,9,9,1330,1348
9,cnt1203,All Industries,1,2011,8,12,1277,1297
10,cnt1204,All Industries,1,2010,8,6,542,556
11,cnt1204,All Industries,1,2011,8,7,528,543
12,cnt1205,All Industries,1,2011,6,9,1294,1309
13,cnt1205,All Industries,1,2010,6,10,1021,1037
14,cnt1206,All Industries,1,2010,20,27,2985,3032
15,cnt1206,All Industries,1,2011,22,30,3017,3069
16,cnt1207,All Industries,1,2011,26,44,3172,3242
17,cnt1207,All Industries,1,2010,36,42,3499,3577
18,cnt1208,All Industries,1,2010,23,20,2000,2043
19,cnt1208,All Industries,1,2011,15,25,1966,2006
20,cnt1209,All Industries,1,2010,344,369,23317,24030
21,cnt1209,All Industries,1,2011,307,370,23320,23997
22,cnt1210,All Industries,1,2010,33,33,2897,2963
23,cnt1210,All Industries,1,2011,26,37,2799,2862
24,cnt1211,All Industries,1,2010,18,24,1602,1644
25,cnt1211,All Industries,1,2011,14,22,1603,1639
26,cnt1212,All Industries,1,2010,19,36,2188,2243
27,cnt1212,All Industries,1,2011,22,35,2316,2373
28,cnt1213,All Industries,1,2010,5,10,538,553
29,cnt1213,All Industries,1,2011,7,9,492,508
30,cnt1214,All Industries,1,2010,12,14,1213,1239
31,cnt1214,All Industries,1,2011,8,13,1241,1262
32,cnt1215,All Industries,1,2011,8,12,954,974
33,cnt1215,All Industries,1,2010,11,13,1030,1054
34,cnt1216,All Industries,1,2010,2,7,449,458
35,cnt1216,All Industries,1,2011,1,8,428,437
36,cnt1217,All Industries,1,2010,54,63,3840,3957
37,cnt1217,All Industries,1,2011,53,66,3731,3850
38,cnt1218,All Industries,1,2010,5,3,876,884
39,cnt1218,All Industries,1,2011,5,3,857,865
40,ecr21,All Industries,1,2011,67,89,5970,6126
41,ecr21,All Industries,1,2010,72,86,6195,6353
42,ecr22,All Industries,1,2010,87,117,8438,8642
43,ecr22,All Industries,1,2011,77,116,8451,8644
44,ecr23,All Industries,1,2010,65,72,6520,6657
45,ecr23,All Industries,1,2011,47,78,6432,6557
46,ecr24,All Industries,1,2010,58,77,8245,8380
47,ecr24,All Industries,1,2011,60,83,8163,8306
48,ecr25,All Industries,1,2011,307,370,23320,23997
49,ecr25,All Industries,1,2010,344,369,23317,24030
50,pro9010,All Industries,1,2011,296,329,25389,26014
51,pro9010,All Industries,1,2010,295,360,25303,25958
52,pro9011,All Industries,1,2010,100,146,10078,10324
53,pro9011,All Industries,1,2011,86,144,10129,10359
54,pro9012,All Industries,1,2010,627,722,52766,54115
55,pro9012,All Industries,1,2011,570,746,52617,53933
56,pro9013,All Industries,1,2010,472,635,41174,42281
57,pro9013,All Industries,1,2011,467,596,40693,41756
58,pro9024,All Industries,1,2010,4697,6766,462648,474111
59,pro9024,All Industries,1,2011,4658,6821,483194,494673
60,pro9035,All Industries,1,2010,9026,10780,860552,880358
61,pro9035,All Industries,1,2011,8634,10586,870401,889621
62,pro9046,All Industries,1,2010,806,1117,74757,76680
63,pro9046,All Industries,1,2011,796,1062,75600,77458
64,pro9047,All Industries,1,2010,609,850,93053,94512
65,pro9047,All Industries,1,2011,613,875,94879,96367
66,pro9048,All Industries,1,2010,2792,3699,331971,338462
67,pro9048,All Industries,1,2011,2700,3655,333672,340027
68,pro9059,All Industries,1,2010,2720,3972,353094,359786
69,pro9059,All Industries,1,2011,2606,3828,362445,368879
70,pro9060,All Industries,1,2011,36,37,2882,2955
71,pro9060,All Industries,1,2010,33,35,2813,2881
72,pro9061,All Industries,1,2010,49,68,2447,2564
73,pro9061,All Industries,1,2011,40,68,2357,2465
74,pro9062,All Industries,1,2011,25,54,737,816
75,pro9062,All Industries,1,2010,24,46,758,828
76,can,"Agriculture, Forestry, Fishing and Hunting",2,2011,226,491,168821,169538
77,cnt1203,"Agriculture, Forestry, Fishing and Hunting",2,2010,1,1,341,343
78,cnt1203,"Agriculture, Forestry, Fishing and Hunting",2,2011,1,3,333,337
79,cnt1206,"Agriculture, Forestry, Fishing and Hunting",2,2011,1,1,306,308
80,cnt1207,"Agriculture, Forestry, Fishing and Hunting",2,2011,1,6,396,403
81,cnt1207,"Agriculture, Forestry, Fishing and Hunting",2,2010,1,11,412,424
82,cnt1210,"Agriculture, Forestry, Fishing and Hunting",2,2010,1,2,284,287
83,cnt1210,"Agriculture, Forestry, Fishing and Hunting",2,2011,1,2,284,287
84,cnt1213,"Agriculture, Forestry, Fishing and Hunting",2,2011,1,1,160,162
85,ecr21,"Agriculture, Forestry, Fishing and Hunting",2,2011,1,1,872,874
86,ecr22,"Agriculture, Forestry, Fishing and Hunting",2,2010,3,3,1207,1213
87,ecr22,"Agriculture, Forestry, Fishing and Hunting",2,2011,3,3,1239,1245
88,ecr23,"Agriculture, Forestry, Fishing and Hunting",2,2010,2,11,759,772
89,ecr23,"Agriculture, Forestry, Fishing and Hunting",2,2011,1,7,769,777
90,ecr24,"Agriculture, Forestry, Fishing and Hunting",2,2010,1,3,1844,1848
91,ecr24,"Agriculture, Forestry, Fishing and Hunting",2,2011,2,4,1888,1894
92,pro9010,"Agriculture, Forestry, Fishing and Hunting",2,2011,5,14,1543,1562
93,pro9011,"Agriculture, Forestry, Fishing and Hunting",2,2011,2,3,2219,2224
94,pro9012,"Agriculture, Forestry, Fishing and Hunting",2,2010,6,18,4984,5008
95,pro9012,"Agriculture, Forestry, Fishing and Hunting",2,2011,7,17,5105,5129
96,pro9013,"Agriculture, Forestry, Fishing and Hunting",2,2011,10,13,3805,3828
97,pro9024,"Agriculture, Forestry, Fishing and Hunting",2,2011,53,123,28357,28533
98,pro9035,"Agriculture, Forestry, Fishing and Hunting",2,2011,65,141,34632,34838
99,pro9046,"Agriculture, Forestry, Fishing and Hunting",2,2011,4,11,13893,13908
100,pro9048,"Agriculture, Forestry, Fishing and Hunting",2,2011,12,40,32184,32236
101,pro9059,"Agriculture, Forestry, Fishing and Hunting",2,2011,68,115,15316,15499
102,can,"Mining, Quarrying, and Oil and Gas Extraction",3,2011,350,378,17361,18089
103,cnt1208,"Mining, Quarrying, and Oil and Gas Extraction",3,2010,3,1,3,7
104,cnt1208,"Mining, Quarrying, and Oil and Gas Extraction",3,2011,3,1,4,8
105,cnt1209,"Mining, Quarrying, and Oil and Gas Extraction",3,2010,4,2,83,89
106,cnt1209,"Mining, Quarrying, and Oil and Gas Extraction",3,2011,1,2,82,85
107,cnt1211,"Mining, Quarrying, and Oil and Gas Extraction",3,2010,1,1,3,5
108,cnt1211,"Mining, Quarrying, and Oil and Gas Extraction",3,2011,1,1,3,5
109,ecr25,Utilities,4,2010,3,3,21,27
110,cnt1213,"Mining, Quarrying, and Oil and Gas Extraction",3,2011,1,1,1,3
111,pro9059,"Mining, Quarrying, and Oil and Gas Extraction",3,2011,23,37,2091,2151
112,ecr22,"Mining, Quarrying, and Oil and Gas Extraction",3,2010,4,2,24,30
113,ecr22,"Mining, Quarrying, and Oil and Gas Extraction",3,2011,2,3,24,29
114,ecr23,"Mining, Quarrying, and Oil and Gas Extraction",3,2010,3,1,19,23
115,ecr23,"Mining, Quarrying, and Oil and Gas Extraction",3,2011,3,1,19,23
116,ecr25,"Mining, Quarrying, and Oil and Gas Extraction",3,2011,1,2,82,85
117,ecr25,"Mining, Quarrying, and Oil and Gas Extraction",3,2010,4,2,83,89
118,pro9010,"Mining, Quarrying, and Oil and Gas Extraction",3,2011,9,3,97,109
119,pro9012,"Mining, Quarrying, and Oil and Gas Extraction",3,2010,11,8,154,173
120,pro9012,"Mining, Quarrying, and Oil and Gas Extraction",3,2011,6,8,149,163
121,pro9013,"Mining, Quarrying, and Oil and Gas Extraction",3,2011,3,6,85,94
122,pro9024,"Mining, Quarrying, and Oil and Gas Extraction",3,2011,31,22,653,706
123,pro9035,"Mining, Quarrying, and Oil and Gas Extraction",3,2011,36,31,1274,1341
124,pro9046,"Mining, Quarrying, and Oil and Gas Extraction",3,2011,7,6,210,223
125,pro9047,"Mining, Quarrying, and Oil and Gas Extraction",3,2011,30,23,1589,1642
126,pro9048,"Mining, Quarrying, and Oil and Gas Extraction",3,2011,200,235,11096,11531
127,pro9060,"Mining, Quarrying, and Oil and Gas Extraction",3,2011,1,1,89,91
128,pro9061,"Mining, Quarrying, and Oil and Gas Extraction",3,2011,4,6,21,31
129,can,Utilities,4,2011,146,98,2115,2359
130,cnt1209,Utilities,4,2010,3,3,21,27
131,cnt1209,Utilities,4,2011,1,3,19,23
132,cnt1210,Utilities,4,2010,1,1,2,4
133,ecr21,Utilities,4,2010,2,1,9,12
134,ecr22,Utilities,4,2010,2,1,8,11
135,ecr22,Utilities,4,2011,2,1,6,9
136,ecr25,Utilities,4,2011,1,3,19,23
137,pro9010,Utilities,4,2011,7,3,34,44
138,pro9012,Utilities,4,2010,8,5,45,58
139,pro9012,Utilities,4,2011,7,5,42,54
140,pro9013,Utilities,4,2011,11,5,38,54
141,pro9024,Utilities,4,2011,18,4,265,287
142,pro9035,Utilities,4,2011,53,36,787,876
143,pro9046,Utilities,4,2011,7,1,54,62
144,pro9047,Utilities,4,2011,8,12,58,78
145,pro9048,Utilities,4,2011,22,14,471,507
146,pro9059,Utilities,4,2011,11,12,342,365
147,pro9061,Utilities,4,2011,2,3,9,14
148,can,Construction,5,2011,1048,1976,273918,276942
149,ecr23,Construction,5,2010,4,4,948,956
150,cnt1207,Construction,5,2011,2,1,410,413
151,cnt1207,Construction,5,2010,2,2,441,445
152,cnt1208,Construction,5,2010,2,2,380,384
153,cnt1208,Construction,5,2011,2,3,384,389
154,cnt1209,Construction,5,2010,20,26,2703,2749
155,cnt1209,Construction,5,2011,12,19,2717,2748
156,cnt1211,Construction,5,2010,1,1,165,167
157,cnt1211,Construction,5,2011,1,1,164,166
158,cnt1217,Construction,5,2010,1,4,378,383
159,ecr21,Construction,5,2010,1,5,590,596
160,ecr22,Construction,5,2010,2,3,933,938
161,ecr22,Construction,5,2011,1,5,936,942
162,ecr23,Construction,5,2011,4,5,978,987
163,ecr25,Construction,5,2011,12,19,2717,2748
164,ecr25,Construction,5,2010,20,26,2703,2749
165,pro9010,Construction,5,2011,10,32,2915,2957
166,pro9011,Construction,5,2011,2,11,1069,1082
167,pro9012,Construction,5,2010,27,39,6057,6123
168,pro9012,Construction,5,2011,17,36,6145,6198
169,pro9013,Construction,5,2011,24,49,4802,4875
170,pro9024,Construction,5,2011,184,427,46171,46782
171,pro9035,Construction,5,2011,364,639,100762,101765
172,pro9046,Construction,5,2011,21,59,7940,8020
173,pro9047,Construction,5,2011,29,60,8574,8663
174,pro9048,Construction,5,2011,252,361,43944,44557
175,pro9059,Construction,5,2011,139,292,50806,51237
176,pro9060,Construction,5,2011,3,3,438,444
177,pro9061,Construction,5,2011,2,5,290,297
178,pro9062,Construction,5,2011,1,2,62,65
179,can,Manufacturing,6,2011,3335,3420,72157,78912
180,cnt1201,Manufacturing,6,2011,2,4,120,126
181,cnt1201,Manufacturing,6,2010,1,4,131,136
182,cnt1202,Manufacturing,6,2011,2,8,88,98
183,cnt1202,Manufacturing,6,2010,2,9,95,106
184,cnt1203,Manufacturing,6,2010,2,3,84,89
185,cnt1203,Manufacturing,6,2011,2,4,67,73
186,cnt1204,Manufacturing,6,2010,3,1,25,29
187,cnt1205,Manufacturing,6,2011,1,2,43,46
188,cnt1206,Manufacturing,6,2010,7,3,126,136
189,cnt1206,Manufacturing,6,2011,6,2,118,126
190,cnt1207,Manufacturing,6,2011,7,3,73,83
191,cnt1207,Manufacturing,6,2010,11,1,84,96
192,cnt1208,Manufacturing,6,2010,6,5,72,83
193,cnt1208,Manufacturing,6,2011,3,3,64,70
194,cnt1209,Manufacturing,6,2010,19,25,509,553
195,cnt1209,Manufacturing,6,2011,12,17,469,498
196,cnt1210,Manufacturing,6,2010,7,6,99,112
197,cnt1210,Manufacturing,6,2011,4,6,80,90
198,cnt1211,Manufacturing,6,2010,5,6,48,59
199,cnt1211,Manufacturing,6,2011,5,3,43,51
200,cnt1212,Manufacturing,6,2010,2,6,74,82
201,cnt1212,Manufacturing,6,2011,5,6,72,83
202,cnt1213,Manufacturing,6,2010,1,2,19,22
203,cnt1213,Manufacturing,6,2011,1,1,18,20
204,cnt1216,Manufacturing,6,2010,1,1,18,20
205,cnt1217,Manufacturing,6,2010,2,7,97,106
206,cnt1217,Manufacturing,6,2011,2,6,77,85
207,ecr21,Manufacturing,6,2011,2,8,146,156
208,ecr21,Manufacturing,6,2010,4,8,172,184
209,ecr22,Manufacturing,6,2010,16,20,273,309
210,ecr22,Manufacturing,6,2011,16,16,240,272
211,ecr23,Manufacturing,6,2010,17,7,196,220
212,ecr23,Manufacturing,6,2011,11,8,180,199
213,ecr24,Manufacturing,6,2010,15,20,461,496
214,ecr24,Manufacturing,6,2011,15,18,417,450
215,ecr25,Manufacturing,6,2011,12,17,469,498
216,ecr25,Manufacturing,6,2010,19,25,509,553
217,pro9010,Manufacturing,6,2011,48,23,590,661
218,pro9011,Manufacturing,6,2011,12,10,291,313
219,pro9012,Manufacturing,6,2010,71,80,1614,1765
220,pro9012,Manufacturing,6,2011,60,70,1459,1589
221,pro9013,Manufacturing,6,2011,72,66,1128,1266
222,pro9024,Manufacturing,6,2011,946,1033,18971,20950
223,pro9035,Manufacturing,6,2011,1452,1392,28430,31274
224,pro9046,Manufacturing,6,2011,115,103,1943,2161
225,pro9047,Manufacturing,6,2011,64,62,1556,1682
226,pro9048,Manufacturing,6,2011,259,312,7090,7661
227,pro9059,Manufacturing,6,2011,307,349,10631,11287
228,can,Wholesale Trade,7,2011,910,1729,99930,102569
229,cnt1202,Wholesale Trade,7,2011,2,1,97,100
230,cnt1209,Wholesale Trade,7,2010,14,19,1211,1244
231,cnt1209,Wholesale Trade,7,2011,12,19,1102,1133
232,cnt1210,Wholesale Trade,7,2010,1,1,162,164
233,cnt1210,Wholesale Trade,7,2011,1,1,144,146
234,cnt1211,Wholesale Trade,7,2010,1,2,76,79
235,cnt1217,Wholesale Trade,7,2010,2,3,141,146
236,cnt1217,Wholesale Trade,7,2011,2,4,136,142
237,ecr21,Wholesale Trade,7,2011,3,6,184,193
238,ecr21,Wholesale Trade,7,2010,3,5,190,198
239,ecr22,Wholesale Trade,7,2010,2,8,368,378
240,ecr22,Wholesale Trade,7,2011,3,4,338,345
241,ecr24,Wholesale Trade,7,2010,1,4,353,358
242,ecr24,Wholesale Trade,7,2011,2,5,341,348
243,ecr25,Wholesale Trade,7,2011,12,19,1102,1133
244,ecr25,Wholesale Trade,7,2010,14,19,1211,1244
245,pro9010,Wholesale Trade,7,2011,4,15,997,1016
246,pro9011,Wholesale Trade,7,2011,4,6,271,281
247,pro9012,Wholesale Trade,7,2010,20,38,2360,2418
248,pro9012,Wholesale Trade,7,2011,20,36,2203,2259
249,pro9013,Wholesale Trade,7,2011,8,35,1637,1680
250,pro9024,Wholesale Trade,7,2011,238,434,22901,23573
251,pro9035,Wholesale Trade,7,2011,445,686,38650,39781
252,pro9046,Wholesale Trade,7,2011,19,62,3086,3167
253,pro9047,Wholesale Trade,7,2011,6,43,3083,3132
254,pro9048,Wholesale Trade,7,2011,86,218,11426,11730
255,pro9059,Wholesale Trade,7,2011,80,190,15542,15812
256,can,Retail Trade,8,2011,3124,4785,206158,214067
257,cnt1201,Retail Trade,8,2011,1,3,102,106
258,cnt1201,Retail Trade,8,2010,1,3,107,111
259,cnt1202,Retail Trade,8,2011,5,2,204,211
260,cnt1202,Retail Trade,8,2010,6,1,208,215
261,cnt1206,Retail Trade,8,2010,2,6,385,393
262,cnt1206,Retail Trade,8,2011,3,8,389,400
263,cnt1207,Retail Trade,8,2011,7,5,382,394
264,cnt1207,Retail Trade,8,2010,6,5,436,447
265,cnt1208,Retail Trade,8,2010,4,3,219,226
266,cnt1208,Retail Trade,8,2011,2,5,212,219
267,cnt1209,Retail Trade,8,2010,40,52,2216,2308
268,cnt1209,Retail Trade,8,2011,44,66,2218,2328
269,cnt1210,Retail Trade,8,2010,7,5,372,384
270,cnt1210,Retail Trade,8,2011,6,5,363,374
271,cnt1211,Retail Trade,8,2010,2,2,236,240
272,cnt1211,Retail Trade,8,2011,2,3,231,236
273,cnt1212,Retail Trade,8,2010,2,8,274,284
274,cnt1212,Retail Trade,8,2011,3,8,276,287
275,cnt1214,Retail Trade,8,2010,3,3,152,158
276,cnt1214,Retail Trade,8,2011,1,3,153,157
277,cnt1215,Retail Trade,8,2011,2,3,111,116
278,cnt1215,Retail Trade,8,2010,3,1,123,127
279,cnt1217,Retail Trade,8,2010,10,10,559,579
280,cnt1217,Retail Trade,8,2011,11,10,542,563
281,ecr21,Retail Trade,8,2011,13,14,802,829
282,ecr21,Retail Trade,8,2010,13,11,829,853
283,ecr22,Retail Trade,8,2010,14,18,1090,1122
284,ecr22,Retail Trade,8,2011,13,19,1072,1104
285,ecr23,Retail Trade,8,2010,10,11,778,799
286,ecr23,Retail Trade,8,2011,9,12,768,789
287,ecr24,Retail Trade,8,2010,9,15,934,958
288,ecr24,Retail Trade,8,2011,9,19,921,949
289,ecr25,Retail Trade,8,2011,44,66,2218,2328
290,ecr25,Retail Trade,8,2010,40,52,2216,2308
291,pro9010,Retail Trade,8,2011,33,63,3541,3637
292,pro9046,Finance and Insurance,11,2011,38,26,4394,4458
293,pro9011,Retail Trade,8,2011,9,26,905,940
294,pro9012,Retail Trade,8,2010,87,107,5859,6053
295,pro9012,Retail Trade,8,2011,91,130,5817,6038
296,pro9013,Retail Trade,8,2011,67,87,4634,4788
297,pro9024,Retail Trade,8,2011,636,1218,47985,49839
298,pro9035,Retail Trade,8,2011,1295,1803,77957,81055
299,pro9047,Retail Trade,8,2011,73,136,6553,6762
300,pro9048,Retail Trade,8,2011,383,597,22719,23699
301,pro9059,Retail Trade,8,2011,435,556,28986,29977
302,pro9060,Retail Trade,8,2011,3,4,254,261
303,pro9061,Retail Trade,8,2011,4,8,228,240
304,pro9062,Retail Trade,8,2011,2,7,76,85
305,can,Transportation and Warehousing,9,2011,905,1171,122834,124910
306,cnt1202,Transportation and Warehousing,9,2011,1,1,70,72
307,cnt1202,Transportation and Warehousing,9,2010,1,1,74,76
308,ecr25,Public Administration,21,2011,34,27,156,217
309,cnt1207,Transportation and Warehousing,9,2010,2,3,140,145
310,cnt1209,Transportation and Warehousing,9,2010,18,18,905,941
311,cnt1209,Transportation and Warehousing,9,2011,15,18,903,936
312,cnt1210,Transportation and Warehousing,9,2010,1,2,192,195
313,cnt1210,Transportation and Warehousing,9,2011,1,3,181,185
314,cnt1212,Transportation and Warehousing,9,2010,1,4,102,107
315,cnt1209,Information and Cultural Industries,10,2011,11,7,463,481
316,cnt1215,Transportation and Warehousing,9,2010,1,1,52,54
317,cnt1217,Transportation and Warehousing,9,2010,2,4,170,176
318,cnt1217,Transportation and Warehousing,9,2011,2,4,166,172
319,ecr21,Transportation and Warehousing,9,2011,2,5,250,257
320,ecr21,Transportation and Warehousing,9,2010,3,5,273,281
321,ecr22,Transportation and Warehousing,9,2010,2,7,468,477
322,ecr22,Transportation and Warehousing,9,2011,1,7,441,449
323,ecr23,Transportation and Warehousing,9,2010,3,4,327,334
324,ecr23,Transportation and Warehousing,9,2011,1,4,287,292
325,ecr24,Transportation and Warehousing,9,2010,1,2,301,304
326,ecr24,Transportation and Warehousing,9,2011,1,2,290,293
327,ecr25,Transportation and Warehousing,9,2011,15,18,903,936
328,ecr25,Transportation and Warehousing,9,2010,18,18,905,941
329,pro9010,Transportation and Warehousing,9,2011,15,16,1200,1231
330,pro9011,Transportation and Warehousing,9,2011,5,5,380,390
331,pro9012,Transportation and Warehousing,9,2010,27,36,2277,2340
332,pro9012,Transportation and Warehousing,9,2011,22,37,2185,2244
333,pro9013,Transportation and Warehousing,9,2011,16,31,2618,2665
334,pro9024,Transportation and Warehousing,9,2011,175,266,23847,24288
335,pro9035,Transportation and Warehousing,9,2011,380,428,46874,47682
336,pro9046,Transportation and Warehousing,9,2011,39,43,4625,4707
337,pro9047,Transportation and Warehousing,9,2011,25,36,4377,4438
338,pro9048,Transportation and Warehousing,9,2011,102,134,18111,18347
339,pro9059,Transportation and Warehousing,9,2011,118,165,18285,18568
340,pro9060,Transportation and Warehousing,9,2011,3,4,102,109
341,pro9061,Transportation and Warehousing,9,2011,5,4,160,169
342,can,Information and Cultural Industries,10,2011,507,515,31600,32622
343,cnt1206,Information and Cultural Industries,10,2011,1,1,39,41
344,cnt1209,Information and Cultural Industries,10,2010,16,4,507,527
345,cnt1217,Information and Cultural Industries,10,2010,1,2,35,38
346,cnt1217,Information and Cultural Industries,10,2011,1,3,30,34
347,ecr21,Information and Cultural Industries,10,2011,2,3,47,52
348,ecr21,Information and Cultural Industries,10,2010,2,2,51,55
349,ecr24,Information and Cultural Industries,10,2010,1,1,77,79
350,ecr24,Information and Cultural Industries,10,2011,1,6,65,72
351,ecr25,Information and Cultural Industries,10,2011,11,7,463,481
352,ecr25,Information and Cultural Industries,10,2010,16,4,507,527
353,pro9010,Information and Cultural Industries,10,2011,7,3,231,241
354,pro9012,Information and Cultural Industries,10,2010,19,12,749,780
355,pro9012,Information and Cultural Industries,10,2011,14,29,688,731
356,pro9013,Information and Cultural Industries,10,2011,19,9,374,402
357,pro9024,Information and Cultural Industries,10,2011,100,126,7068,7294
358,pro9035,Information and Cultural Industries,10,2011,221,210,13591,14022
359,pro9046,Information and Cultural Industries,10,2011,18,12,721,751
360,pro9047,Information and Cultural Industries,10,2011,17,11,780,808
361,pro9048,Information and Cultural Industries,10,2011,49,38,2531,2618
362,pro9059,Information and Cultural Industries,10,2011,60,69,5445,5574
363,pro9061,Information and Cultural Industries,10,2011,1,3,22,26
364,can,Finance and Insurance,11,2011,819,992,132238,134049
365,cnt1209,Finance and Insurance,11,2010,14,18,1685,1717
366,cnt1209,Finance and Insurance,11,2011,18,16,1706,1740
367,cnt1217,Finance and Insurance,11,2011,1,1,188,190
368,ecr21,Finance and Insurance,11,2011,1,1,266,268
369,ecr25,Finance and Insurance,11,2011,18,16,1706,1740
370,ecr25,Finance and Insurance,11,2010,14,18,1685,1717
371,pro9010,Finance and Insurance,11,2011,8,7,934,949
372,ecr24,Public Administration,21,2011,3,6,25,34
373,pro9011,Finance and Insurance,11,2011,3,6,459,468
374,pro9012,Finance and Insurance,11,2010,15,20,3165,3200
375,pro9012,Finance and Insurance,11,2011,19,19,3236,3274
376,pro9013,Finance and Insurance,11,2011,13,20,2077,2110
377,pro9024,Finance and Insurance,11,2011,151,289,26677,27117
378,pro9035,Finance and Insurance,11,2011,395,334,53616,54345
379,pro9047,Finance and Insurance,11,2011,29,28,3802,3859
380,pro9048,Finance and Insurance,11,2011,74,98,16345,16517
381,pro9059,Finance and Insurance,11,2011,87,164,20437,20688
382,pro9060,Finance and Insurance,11,2011,1,1,137,139
383,can,"Real Estate, Rental and Leasing",12,2011,306,518,240015,240839
384,cnt1209,"Real Estate, Rental and Leasing",12,2010,9,8,2244,2261
385,cnt1209,"Real Estate, Rental and Leasing",12,2011,7,9,2564,2580
386,ecr22,"Real Estate, Rental and Leasing",12,2010,1,1,522,524
387,ecr25,"Real Estate, Rental and Leasing",12,2011,7,9,2564,2580
388,ecr25,"Real Estate, Rental and Leasing",12,2010,9,8,2244,2261
389,pro9010,"Real Estate, Rental and Leasing",12,2011,2,3,1948,1953
390,pro9011,"Real Estate, Rental and Leasing",12,2011,1,1,745,747
391,pro9012,"Real Estate, Rental and Leasing",12,2010,12,10,3980,4002
392,pro9012,"Real Estate, Rental and Leasing",12,2011,9,10,4520,4539
393,pro9013,"Real Estate, Rental and Leasing",12,2011,3,5,3128,3136
394,pro9024,"Real Estate, Rental and Leasing",12,2011,52,105,54421,54578
395,pro9035,"Real Estate, Rental and Leasing",12,2011,133,208,92245,92586
396,pro9046,"Real Estate, Rental and Leasing",12,2011,11,15,5764,5790
397,pro9047,"Real Estate, Rental and Leasing",12,2011,4,14,5454,5472
398,pro9048,"Real Estate, Rental and Leasing",12,2011,57,77,28907,29041
399,pro9059,"Real Estate, Rental and Leasing",12,2011,34,77,42401,42512
400,can,"Professional, Scientific and Technical Services",13,2011,962,1250,316412,318624
401,cnt1206,"Professional, Scientific and Technical Services",13,2011,1,1,224,226
402,cnt1209,"Professional, Scientific and Technical Services",13,2010,18,20,3102,3140
403,cnt1209,"Professional, Scientific and Technical Services",13,2011,13,16,3106,3135
404,pro9048,"Professional, Scientific and Technical Services",13,2011,129,174,54058,54361
405,cnt1217,"Professional, Scientific and Technical Services",13,2011,1,1,247,249
406,ecr21,"Professional, Scientific and Technical Services",13,2011,1,1,354,356
407,ecr21,"Professional, Scientific and Technical Services",13,2010,1,1,373,375
408,pro9024,Management of Companies and Enterprises,14,2011,144,104,15310,15558
409,ecr24,"Professional, Scientific and Technical Services",13,2011,1,1,418,420
410,ecr25,"Professional, Scientific and Technical Services",13,2011,13,16,3106,3135
411,ecr25,"Professional, Scientific and Technical Services",13,2010,18,20,3102,3140
412,pro9010,"Professional, Scientific and Technical Services",13,2011,12,6,1955,1973
413,pro9012,"Professional, Scientific and Technical Services",13,2010,19,27,4923,4969
414,pro9012,"Professional, Scientific and Technical Services",13,2011,16,24,4917,4957
415,pro9013,"Professional, Scientific and Technical Services",13,2011,14,14,3354,3382
416,pro9024,"Professional, Scientific and Technical Services",13,2011,227,285,58489,59001
417,pro9035,"Professional, Scientific and Technical Services",13,2011,398,541,132832,133771
418,pro9046,"Professional, Scientific and Technical Services",13,2011,21,26,5730,5777
419,pro9047,"Professional, Scientific and Technical Services",13,2011,15,19,5640,5674
420,pro9059,"Professional, Scientific and Technical Services",13,2011,128,158,48147,48433
421,pro9061,"Professional, Scientific and Technical Services",13,2011,1,1,262,264
422,can,Management of Companies and Enterprises,14,2011,717,528,88251,89496
423,cnt1209,Management of Companies and Enterprises,14,2010,15,11,1421,1447
424,cnt1209,Management of Companies and Enterprises,14,2011,15,10,1378,1403
425,cnt1212,Management of Companies and Enterprises,14,2011,2,1,82,85
426,cnt1215,Management of Companies and Enterprises,14,2010,1,1,25,27
427,ecr21,Management of Companies and Enterprises,14,2010,2,1,158,161
428,ecr22,Management of Companies and Enterprises,14,2011,2,1,300,303
429,ecr25,Management of Companies and Enterprises,14,2011,15,10,1378,1403
430,ecr25,Management of Companies and Enterprises,14,2010,15,11,1421,1447
431,pro9010,Management of Companies and Enterprises,14,2011,7,4,771,782
432,pro9011,Management of Companies and Enterprises,14,2011,2,1,383,386
433,pro9012,Management of Companies and Enterprises,14,2010,22,12,2361,2395
434,pro9012,Management of Companies and Enterprises,14,2011,20,11,2289,2320
435,pro9013,Management of Companies and Enterprises,14,2011,14,7,1536,1557
436,pro9062,Educational Services,16,2011,1,3,38,42
437,pro9035,Management of Companies and Enterprises,14,2011,293,221,35447,35961
438,pro9046,Management of Companies and Enterprises,14,2011,22,22,2883,2927
439,pro9047,Management of Companies and Enterprises,14,2011,13,22,4472,4507
440,pro9048,Management of Companies and Enterprises,14,2011,124,80,10870,11074
441,cnt1212,Educational Services,16,2011,1,1,8,10
442,pro9059,Management of Companies and Enterprises,14,2011,76,54,14043,14173
443,pro9060,Management of Companies and Enterprises,14,2011,1,1,140,142
444,can,"56 - Administrative and Support, Waste Management and Remediati",15,2011,1410,1460,106720,109590
445,cnt1202,"56 - Administrative and Support, Waste Management and Remediati",15,2010,1,1,42,44
446,cnt1205,"56 - Administrative and Support, Waste Management and Remediati",15,2010,1,1,26,28
447,cnt1206,"56 - Administrative and Support, Waste Management and Remediati",15,2010,1,1,104,106
448,cnt1207,"56 - Administrative and Support, Waste Management and Remediati",15,2010,1,1,119,121
449,cnt1209,"56 - Administrative and Support, Waste Management and Remediati",15,2010,33,27,1003,1063
450,cnt1209,"56 - Administrative and Support, Waste Management and Remediati",15,2011,34,29,960,1023
451,cnt1210,"56 - Administrative and Support, Waste Management and Remediati",15,2010,1,1,87,89
452,cnt1217,"56 - Administrative and Support, Waste Management and Remediati",15,2010,4,4,141,149
453,cnt1217,"56 - Administrative and Support, Waste Management and Remediati",15,2011,4,4,136,144
454,ecr21,"56 - Administrative and Support, Waste Management and Remediati",15,2011,5,4,193,202
455,ecr21,"56 - Administrative and Support, Waste Management and Remediati",15,2010,4,5,198,207
456,ecr22,"56 - Administrative and Support, Waste Management and Remediati",15,2010,3,2,246,251
457,ecr22,"56 - Administrative and Support, Waste Management and Remediati",15,2011,2,1,244,247
458,ecr23,"56 - Administrative and Support, Waste Management and Remediati",15,2010,2,3,208,213
459,ecr24,"56 - Administrative and Support, Waste Management and Remediati",15,2010,2,2,203,207
460,ecr25,"56 - Administrative and Support, Waste Management and Remediati",15,2011,34,29,960,1023
461,ecr25,"56 - Administrative and Support, Waste Management and Remediati",15,2010,33,27,1003,1063
462,pro9010,"56 - Administrative and Support, Waste Management and Remediati",15,2011,11,16,802,829
463,pro9011,"56 - Administrative and Support, Waste Management and Remediati",15,2011,1,5,271,277
464,pro9012,"56 - Administrative and Support, Waste Management and Remediati",15,2010,44,39,1860,1943
465,pro9012,"56 - Administrative and Support, Waste Management and Remediati",15,2011,41,40,1805,1886
466,pro9013,"56 - Administrative and Support, Waste Management and Remediati",15,2011,30,30,1440,1500
467,pro9024,"56 - Administrative and Support, Waste Management and Remediati",15,2011,291,354,29287,29932
468,pro9035,"56 - Administrative and Support, Waste Management and Remediati",15,2011,705,561,37790,39056
469,pro9046,"56 - Administrative and Support, Waste Management and Remediati",15,2011,39,45,2543,2627
470,pro9047,"56 - Administrative and Support, Waste Management and Remediati",15,2011,17,28,2380,2425
471,pro9048,"56 - Administrative and Support, Waste Management and Remediati",15,2011,141,153,14064,14358
472,pro9059,"56 - Administrative and Support, Waste Management and Remediati",15,2011,130,221,15985,16336
473,cnt1218,Public Administration,21,2010,1,1,2,4
474,pro9061,"56 - Administrative and Support, Waste Management and Remediati",15,2011,2,3,151,156
475,pro9062,"56 - Administrative and Support, Waste Management and Remediati",15,2011,1,4,38,43
476,ecr23,Educational Services,16,2010,3,4,51,58
477,can,Educational Services,16,2011,862,486,21988,23336
478,cnt1202,Educational Services,16,2011,1,1,11,13
479,cnt1202,Educational Services,16,2010,1,1,11,13
480,cnt1206,Educational Services,16,2010,1,1,21,23
481,cnt1206,Educational Services,16,2011,1,1,21,23
482,cnt1207,Educational Services,16,2011,1,1,30,32
483,cnt1207,Educational Services,16,2010,2,1,33,36
484,cnt1209,Educational Services,16,2010,10,13,275,298
485,cnt1209,Educational Services,16,2011,4,12,264,280
486,cnt1210,Educational Services,16,2010,2,1,25,28
487,cnt1210,Educational Services,16,2011,2,1,24,27
488,cnt1211,Educational Services,16,2010,1,1,6,8
489,cnt1212,Educational Services,16,2010,1,1,9,11
490,cnt1215,Educational Services,16,2011,1,1,3,5
491,cnt1215,Educational Services,16,2010,1,1,6,8
492,cnt1217,Educational Services,16,2010,3,1,42,46
493,cnt1217,Educational Services,16,2011,3,1,34,38
494,ecr21,Educational Services,16,2011,4,2,43,49
495,ecr21,Educational Services,16,2010,4,2,54,60
496,ecr22,Educational Services,16,2010,5,3,52,60
497,ecr22,Educational Services,16,2011,3,3,50,56
498,ecr23,Educational Services,16,2011,1,4,46,51
499,ecr24,Educational Services,16,2010,4,3,40,47
500,ecr24,Educational Services,16,2011,3,3,40,46
501,ecr25,Educational Services,16,2011,4,12,264,280
502,ecr25,Educational Services,16,2010,10,13,275,298
503,pro9010,Educational Services,16,2011,12,9,208,229
504,pro9011,Educational Services,16,2011,6,1,88,95
505,pro9012,Educational Services,16,2010,26,25,472,523
506,pro9012,Educational Services,16,2011,15,24,443,482
507,pro9013,Educational Services,16,2011,14,16,319,349
508,pro9024,Educational Services,16,2011,260,132,3626,4018
509,pro9035,Educational Services,16,2011,210,147,9111,9468
510,pro9046,Educational Services,16,2011,56,23,613,692
511,pro9047,Educational Services,16,2011,50,23,520,593
512,pro9048,Educational Services,16,2011,105,36,2910,3051
513,pro9059,Educational Services,16,2011,129,69,4037,4235
514,pro9061,Educational Services,16,2011,2,3,45,50
515,can,Health Care and Social Assistance,17,2011,2365,2391,121801,126557
516,cnt1201,Health Care and Social Assistance,17,2011,2,2,26,30
517,cnt1201,Health Care and Social Assistance,17,2010,1,2,34,37
518,cnt1202,Health Care and Social Assistance,17,2011,4,1,103,108
519,cnt1202,Health Care and Social Assistance,17,2010,4,1,109,114
520,cnt1204,Health Care and Social Assistance,17,2010,3,1,38,42
521,cnt1204,Health Care and Social Assistance,17,2011,3,1,41,45
522,cnt1205,Health Care and Social Assistance,17,2011,2,2,60,64
523,cnt1205,Health Care and Social Assistance,17,2010,2,1,48,51
524,cnt1206,Health Care and Social Assistance,17,2010,6,4,182,192
525,cnt1206,Health Care and Social Assistance,17,2011,6,4,186,196
526,cnt1207,Health Care and Social Assistance,17,2011,5,4,239,248
527,cnt1207,Health Care and Social Assistance,17,2010,5,2,263,270
528,cnt1208,Health Care and Social Assistance,17,2010,3,2,109,114
529,cnt1209,Health Care and Social Assistance,17,2010,38,23,1702,1763
530,cnt1209,Health Care and Social Assistance,17,2011,37,26,1756,1819
531,cnt1210,Health Care and Social Assistance,17,2010,4,5,173,182
532,cnt1210,Health Care and Social Assistance,17,2011,3,7,156,166
533,cnt1211,Health Care and Social Assistance,17,2010,4,3,91,98
534,cnt1211,Health Care and Social Assistance,17,2011,4,3,88,95
535,cnt1212,Health Care and Social Assistance,17,2010,4,4,136,144
536,cnt1212,Health Care and Social Assistance,17,2011,3,4,148,155
537,cnt1213,Health Care and Social Assistance,17,2010,1,3,27,31
538,cnt1213,Health Care and Social Assistance,17,2011,1,3,24,28
539,cnt1214,Health Care and Social Assistance,17,2010,3,2,89,94
540,cnt1214,Health Care and Social Assistance,17,2011,3,1,87,91
541,cnt1215,Health Care and Social Assistance,17,2011,1,3,54,58
542,cnt1215,Health Care and Social Assistance,17,2010,1,3,52,56
543,cnt1216,Health Care and Social Assistance,17,2010,1,2,16,19
544,cnt1216,Health Care and Social Assistance,17,2011,1,2,14,17
545,cnt1217,Health Care and Social Assistance,17,2010,16,11,380,407
546,cnt1217,Health Care and Social Assistance,17,2011,15,11,370,396
547,ecr21,Health Care and Social Assistance,17,2011,19,16,473,508
548,ecr21,Health Care and Social Assistance,17,2010,20,16,487,523
549,ecr22,Health Care and Social Assistance,17,2010,16,17,516,549
550,ecr22,Health Care and Social Assistance,17,2011,14,18,503,535
551,ecr23,Health Care and Social Assistance,17,2010,10,5,420,435
552,ecr23,Health Care and Social Assistance,17,2011,8,6,399,413
553,ecr24,Health Care and Social Assistance,17,2010,17,8,413,438
554,ecr24,Health Care and Social Assistance,17,2011,18,8,403,429
555,ecr25,Health Care and Social Assistance,17,2011,37,26,1756,1819
556,ecr25,Health Care and Social Assistance,17,2010,38,23,1702,1763
557,pro9010,Health Care and Social Assistance,17,2011,44,34,2057,2135
558,pro9011,Health Care and Social Assistance,17,2011,11,12,470,493
559,pro9012,Health Care and Social Assistance,17,2010,101,69,3539,3709
560,pro9012,Health Care and Social Assistance,17,2011,96,74,3548,3718
561,pro9013,Health Care and Social Assistance,17,2011,65,76,3000,3141
562,pro9024,Health Care and Social Assistance,17,2011,511,590,23456,24557
563,pro9035,Health Care and Social Assistance,17,2011,929,829,45609,47367
564,pro9046,Health Care and Social Assistance,17,2011,108,136,4523,4767
565,pro9047,Health Care and Social Assistance,17,2011,95,115,3533,3743
566,pro9048,Health Care and Social Assistance,17,2011,242,240,14728,15210
567,pro9059,Health Care and Social Assistance,17,2011,258,276,20494,21028
568,pro9060,Health Care and Social Assistance,17,2011,2,1,176,179
569,pro9061,Health Care and Social Assistance,17,2011,1,4,131,136
570,pro9062,Health Care and Social Assistance,17,2011,3,4,76,83
571,can,"Arts, Entertainment and Recreation",18,2011,530,689,37276,38495
572,cnt1202,Public Administration,21,2011,1,2,3,6
573,cnt1209,"Arts, Entertainment and Recreation",18,2010,7,5,369,381
574,cnt1209,"Arts, Entertainment and Recreation",18,2011,6,7,349,362
575,cnt1210,"Arts, Entertainment and Recreation",18,2010,1,2,48,51
576,cnt1210,"Arts, Entertainment and Recreation",18,2011,2,1,52,55
577,cnt1217,"Arts, Entertainment and Recreation",18,2010,2,2,90,94
578,cnt1217,"Arts, Entertainment and Recreation",18,2011,2,3,67,72
579,ecr21,"Arts, Entertainment and Recreation",18,2011,2,4,111,117
580,ecr21,"Arts, Entertainment and Recreation",18,2010,2,3,140,145
581,ecr22,"Arts, Entertainment and Recreation",18,2010,1,4,136,141
582,ecr22,"Arts, Entertainment and Recreation",18,2011,2,3,138,143
583,ecr23,"Arts, Entertainment and Recreation",18,2010,1,2,107,110
584,ecr23,"Arts, Entertainment and Recreation",18,2011,1,2,105,108
585,ecr25,"Arts, Entertainment and Recreation",18,2011,6,7,349,362
586,ecr25,"Arts, Entertainment and Recreation",18,2010,7,5,369,381
587,pro9010,"Arts, Entertainment and Recreation",18,2011,1,6,486,493
588,pro9011,"Arts, Entertainment and Recreation",18,2011,2,5,181,188
589,pro9012,"Arts, Entertainment and Recreation",18,2010,11,15,897,923
590,pro9012,"Arts, Entertainment and Recreation",18,2011,11,18,844,873
591,pro9013,"Arts, Entertainment and Recreation",18,2011,10,10,655,675
592,pro9024,"Arts, Entertainment and Recreation",18,2011,114,168,9712,9994
593,cnt1218,Public Administration,21,2011,1,1,3,5
594,pro9035,"Arts, Entertainment and Recreation",18,2011,206,241,13803,14250
595,pro9046,"Arts, Entertainment and Recreation",18,2011,15,35,1072,1122
596,cnt1210,Accommodation and Food Services,19,2011,3,4,128,135
597,pro9047,"Arts, Entertainment and Recreation",18,2011,14,25,952,991
598,pro9048,"Arts, Entertainment and Recreation",18,2011,77,77,3486,3640
599,pro9059,"Arts, Entertainment and Recreation",18,2011,80,104,5974,6158
600,can,Accommodation and Food Services,19,2011,1179,4270,93205,98654
601,cnt1202,Accommodation and Food Services,19,2011,1,1,58,60
602,cnt1202,Accommodation and Food Services,19,2010,1,3,58,62
603,cnt1203,Accommodation and Food Services,19,2010,1,1,86,88
604,cnt1202,Public Administration,21,2010,1,2,1,4
605,cnt1206,Accommodation and Food Services,19,2011,1,5,149,155
606,cnt1209,Accommodation and Food Services,19,2010,18,45,1007,1070
607,cnt1209,Accommodation and Food Services,19,2011,18,47,974,1039
608,cnt1210,Accommodation and Food Services,19,2010,3,2,138,143
609,cnt1211,Accommodation and Food Services,19,2010,1,2,80,83
610,cnt1214,Accommodation and Food Services,19,2010,1,3,60,64
611,cnt1214,Accommodation and Food Services,19,2011,1,1,59,61
612,cnt1217,Accommodation and Food Services,19,2010,2,10,225,237
613,cnt1217,Accommodation and Food Services,19,2011,1,11,214,226
614,ecr21,Accommodation and Food Services,19,2011,2,12,414,428
615,ecr21,Accommodation and Food Services,19,2010,3,11,440,454
616,ecr22,Accommodation and Food Services,19,2010,6,11,428,445
617,ecr22,Accommodation and Food Services,19,2011,5,10,414,429
618,ecr24,Accommodation and Food Services,19,2010,3,8,369,380
619,ecr24,Accommodation and Food Services,19,2011,4,6,347,357
620,ecr25,Accommodation and Food Services,19,2011,18,47,974,1039
621,ecr25,Accommodation and Food Services,19,2010,18,45,1007,1070
622,pro9010,Accommodation and Food Services,19,2011,9,39,1451,1499
623,pro9011,Accommodation and Food Services,19,2011,6,34,515,555
624,pro9012,Accommodation and Food Services,19,2010,30,85,2532,2647
625,pro9012,Accommodation and Food Services,19,2011,30,85,2436,2551
626,pro9013,Accommodation and Food Services,19,2011,18,74,1971,2063
627,pro9024,Accommodation and Food Services,19,2011,195,815,23082,24092
628,pro9035,Accommodation and Food Services,19,2011,418,1670,32973,35061
629,pro9046,Accommodation and Food Services,19,2011,64,165,2613,2842
630,pro9047,Accommodation and Food Services,19,2011,33,132,2850,3015
631,pro9048,Accommodation and Food Services,19,2011,157,544,10112,10813
632,pro9059,Accommodation and Food Services,19,2011,243,697,14828,15768
633,pro9060,Accommodation and Food Services,19,2011,3,7,201,211
634,pro9061,Accommodation and Food Services,19,2011,2,6,132,140
635,pro9062,Accommodation and Food Services,19,2011,1,2,41,44
636,can,Other Services (except Public Administration),20,2011,525,883,195727,197135
637,cnt1207,Other Services (except Public Administration),20,2010,1,1,320,322
638,cnt1209,Other Services (except Public Administration),20,2010,13,23,1915,1951
639,cnt1209,Other Services (except Public Administration),20,2011,13,18,1815,1846
640,cnt1206,Public Administration,21,2011,2,2,6,10
641,cnt1217,Other Services (except Public Administration),20,2010,1,3,429,433
642,cnt1217,Other Services (except Public Administration),20,2011,1,1,412,414
643,ecr21,Other Services (except Public Administration),20,2011,1,1,628,630
644,ecr21,Other Services (except Public Administration),20,2010,1,3,675,679
645,ecr22,Other Services (except Public Administration),20,2010,1,3,773,777
646,ecr22,Other Services (except Public Administration),20,2011,1,4,784,789
647,ecr23,Other Services (except Public Administration),20,2010,1,1,662,664
648,ecr25,Other Services (except Public Administration),20,2011,13,18,1815,1846
649,ecr25,Other Services (except Public Administration),20,2010,13,23,1915,1951
650,pro9010,Other Services (except Public Administration),20,2011,5,12,3244,3261
651,pro9011,Other Services (except Public Administration),20,2011,1,3,873,877
652,pro9012,Other Services (except Public Administration),20,2010,16,31,4699,4746
653,pro9012,Other Services (except Public Administration),20,2011,15,25,4543,4583
654,cnt1207,Public Administration,21,2011,1,3,9,13
655,pro9013,Other Services (except Public Administration),20,2011,3,12,3842,3857
656,pro9024,Other Services (except Public Administration),20,2011,109,210,41409,41728
657,pro9035,Other Services (except Public Administration),20,2011,213,307,73250,73770
658,pro9046,Other Services (except Public Administration),20,2011,22,43,6018,6083
659,pro9047,Other Services (except Public Administration),20,2011,13,22,5938,5973
660,pro9048,Other Services (except Public Administration),20,2011,70,128,28114,28312
661,pro9059,Other Services (except Public Administration),20,2011,71,119,27959,28149
662,pro9061,Other Services (except Public Administration),20,2011,1,2,238,241
663,can,Public Administration,21,2011,1301,771,6468,8540
664,cnt1206,Public Administration,21,2010,2,2,7,11
665,cnt1207,Public Administration,21,2010,2,2,10,14
666,cnt1208,Public Administration,21,2010,2,1,1,4
667,cnt1209,Public Administration,21,2010,35,26,153,214
668,cnt1209,Public Administration,21,2011,34,27,156,217
669,cnt1210,Public Administration,21,2010,4,1,10,15
670,cnt1210,Public Administration,21,2011,3,1,9,13
671,cnt1211,Public Administration,21,2010,1,1,4,6
672,cnt1211,Public Administration,21,2011,1,1,4,6
673,cnt1212,Public Administration,21,2010,2,1,6,9
674,cnt1212,Public Administration,21,2011,3,1,7,11
675,cnt1215,Public Administration,21,2011,1,2,3,6
676,cnt1215,Public Administration,21,2010,1,2,4,7
677,ecr21,Public Administration,21,2011,5,3,20,28
678,ecr21,Public Administration,21,2010,5,4,21,30
679,ecr22,Public Administration,21,2010,7,7,26,40
680,ecr22,Public Administration,21,2011,7,7,26,40
681,ecr23,Public Administration,21,2010,5,3,15,23
682,ecr23,Public Administration,21,2011,5,5,14,24
683,ecr24,Public Administration,21,2010,3,6,24,33
684,ecr25,Public Administration,21,2010,35,26,153,214
685,pro9010,Public Administration,21,2011,47,21,385,453
686,pro9011,Public Administration,21,2011,18,10,276,304
687,pro9012,Public Administration,21,2010,55,46,239,340
688,pro9012,Public Administration,21,2011,54,48,243,345
689,pro9013,Public Administration,21,2011,53,31,250,334
690,pro9024,Public Administration,21,2011,223,116,1507,1846
691,pro9035,Public Administration,21,2011,423,161,768,1352
692,pro9046,Public Administration,21,2011,77,79,472,628
693,pro9047,Public Administration,21,2011,78,50,1077,1205
694,pro9048,Public Administration,21,2011,159,99,506,764
695,pro9059,Public Administration,21,2011,129,104,696,929
696,pro9060,Public Administration,21,2011,15,11,105,131
697,pro9061,Public Administration,21,2011,12,18,133,163
698,pro9062,Public Administration,21,2011,13,23,50,86
